17
13
26 4  5  6  5  6  5  6  5  6  5  6  5  6  5  7  19
26 16 0  0  0  0  0  0  0  0  0  0  0  0  0  8  19
26 17 0  3  0  3  0  3  0  3  0  3  0  3  0  9  19
26 18 0  1  0  1  0  1  0  1  0  1  0  1  0  10 19
25 16 0  3  0  3  0  3  0  3  0  3  0  3  0  8  19
25 16 0  1  0  1  0  1  0  1  0  1  0  1  0  8  19
25 16 0  3  0  3  0  3  0  3  0  3  0  3  0  8  19 
25 16 0  1  0  1  0  1  0  1  0  1  0  1  0  8  19
25 16 0  3  0  3  0  3  0  3  0  3  0  3  0  8  19
25 17 0  1  0  1  0  1  0  1  0  1  0  1  0  9  19
25 18 0  3  0  3  0  3  0  3  0  3  0  3  0  10 19
25 16 0  1  0  1  0  1  0  1  0  1  0  1  0  8  19
25 14 15 14 15 14 15 14 15 14 15 14 15 14 15 14 20