17
32
26 4  5  6  5  6  5  6  5  6  5  6  5  6  5  7  20
27 17 0  0  0  0  0  0  0  0  0  0  0  0  0  9  19
26 16 0  3  0  3  0  3  0  3  0  3  0  3  0  8  20
27 17 0  1  0  1  0  1  0  1  0  1  0  1  0  9  19
26 16 0  3  0  3  0  3  0  3  0  3  0  3  0  8  20
27 17 0  1  0  1  0  1  0  1  0  1  0  1  0  9  19
26 16 0  3  0  3  0  3  0  3  0  3  0  3  0  8  20 
27 17 0  1  0  1  0  1  0  1  0  1  0  1  0  9  19
26 16 0  3  0  3  0  3  0  3  0  3  0  3  0  8  20
27 17 0  1  0  1  0  1  0  1  0  1  0  1  0  9  19
26 16 0  3  0  3  0  3  0  3  0  3  0  3  0  8  20
27 17 0  1  0  1  0  1  0  1  0  1  0  1  0  9  19
26 16 0  3  0  3  0  3  0  3  0  3  0  3  0  8  20
27 17 0  1  0  1  0  1  0  1  0  1  0  1  0  9  19
26 16 0  3  0  3  0  3  0  3  0  3  0  3  0  8  20
27 17 0  1  0  1  0  1  0  1  0  1  0  1  0  9  19
26 16 0  3  0  3  0  3  0  3  0  3  0  3  0  8  20
27 17 0  1  0  1  0  1  0  1  0  1  0  1  0  9  19
26 16 0  3  0  3  0  3  0  3  0  3  0  3  0  8  20
27 17 0  1  0  1  0  1  0  1  0  1  0  1  0  9  19
26 16 0  3  0  3  0  3  0  3  0  3  0  3  0  8  20
27 17 0  1  0  1  0  1  0  1  0  1  0  1  0  9  19
26 16 0  3  0  3  0  3  0  3  0  3  0  3  0  8  20
27 17 0  1  0  1  0  1  0  1  0  1  0  1  0  9  19
26 16 0  3  0  3  0  3  0  3  0  3  0  3  0  8  20
27 17 0  1  0  1  0  1  0  1  0  1  0  1  0  9  19
26 16 0  3  0  3  0  3  0  3  0  3  0  3  0  8  20
27 17 0  1  0  1  0  1  0  1  0  1  0  1  0  9  19
26 16 0  3  0  3  0  3  0  3  0  3  0  3  0  8  20
27 17 0  1  0  1  0  1  0  1  0  1  0  1  0  9  19
25 15 13 14 13 14 13 14 13 14 13 14 13 14 13 14 20
27 22 23 22 23 22 23 22 23 22 23 22 23 22 23 22 19

# Map 4-1, 4-4, 4-5