17
32
26 4  5  6  5  6  5  6  5  6  5  6  5  6  5  7  19
26 16 0  0  0  0  0  0  0  0  0  0  0  0  0  8  19
26 17 0  3  0  3  0  3  0  3  0  3  0  3  0  9  19
26 16 0  1  0  1  0  1  0  1  0  1  0  1  0  8  19
26 17 0  3  0  3  0  3  0  3  0  3  0  3  0  9  19
26 16 0  1  0  1  0  1  0  1  0  1  0  1  0  8  19
26 17 0  3  0  3  0  3  0  3  0  3  0  3  0  9  19 
26 16 0  1  0  1  0  1  0  1  0  1  0  1  0  8  19
26 17 0  3  0  3  0  3  0  3  0  3  0  3  0  9  19
26 16 0  1  0  1  0  1  0  1  0  1  0  1  0  8  19
26 17 0  3  0  3  0  3  0  3  0  3  0  3  0  9  19
26 16 0  1  0  1  0  1  0  1  0  1  0  1  0  8  19
26 17 0  3  0  3  0  3  0  3  0  3  0  3  0  9  19
26 16 0  1  0  1  0  1  0  1  0  1  0  1  0  8  19
26 17 0  3  0  3  0  3  0  3  0  3  0  3  0  9  19
26 16 0  1  0  1  0  1  0  1  0  1  0  1  0  8  19
26 17 0  3  0  3  0  3  0  3  0  3  0  3  0  9  19
26 16 0  1  0  1  0  1  0  1  0  1  0  1  0  8  19
26 17 0  3  0  3  0  3  0  3  0  3  0  3  0  9  19
26 16 0  1  0  1  0  1  0  1  0  1  0  1  0  8  19
26 17 0  3  0  3  0  3  0  3  0  3  0  3  0  9  19
26 16 0  1  0  1  0  1  0  1  0  1  0  1  0  8  19
26 17 0  3  0  3  0  3  0  3  0  3  0  3  0  9  19
26 16 0  1  0  1  0  1  0  1  0  1  0  1  0  8  19
26 17 0  3  0  3  0  3  0  3  0  3  0  3  0  9  19
26 16 0  1  0  1  0  1  0  1  0  1  0  1  0  8  19
26 17 0  3  0  3  0  3  0  3  0  3  0  3  0  9  19
26 16 0  1  0  1  0  1  0  1  0  1  0  1  0  8  19
26 17 0  3  0  3  0  3  0  3  0  3  0  3  0  9  19
26 16 0  1  0  1  0  1  0  1  0  1  0  1  0  8  19
25 15 12 13 14 12 13 14 12 13 14 12 13 14 12 11 21
25 23 23 23 23 23 23 23 23 23 23 23 23 23 23 23 21

# Map 5-3, 5-6